X,0,1,2,3,4,5,6
0,0,0,B,B,B,0,0
1,0,0,B,B,B,0,0
2,B,B,B,B,B,B,B
3,B,B,B,E,B,B,B
4,B,B,B,B,B,B,B
5,0,0,B,B,B,0,0
6,0,0,B,B,B,0,0

